44144414444111111111-
14141414114111111111-
14141414114111111111-
14141414114144411111-
14141414114141411111-
14141414114141411111-
14441444114441411111-
11111111111111411111-
11111111111111411111-
44444444444444411111-
11111111111111111111-
00000009